Accession	Division
Acyrthosiphon_pisum	Metazoa
Adineta_vaga	Metazoa
Aedes_aegypti	Metazoa
Amphimedon_queenslandica	Metazoa
Anopheles_darlingi	Metazoa
Anopheles_gambiae	Metazoa
Anoplophora_glabripennis	Metazoa
Apis_mellifera	Metazoa
Atta_cephalotes	Metazoa
Belgica_antarctica	Metazoa
Bombus_impatiens	Metazoa
Bombus_terrestris	Metazoa
Bombyx_mori	Metazoa
Branchiostoma_lanceolatum	Metazoa
Brugia_malayi	Metazoa
Caenorhabditis_brenneri	Metazoa
Caenorhabditis_briggsae	Metazoa
Caenorhabditis_elegans	Metazoa
Caenorhabditis_japonica	Metazoa
Caenorhabditis_remanei	Metazoa
Capitella_teleta	Metazoa
Crassostrea_gigas	Metazoa
Culex_quinquefasciatus	Metazoa
Culicoides_sonorensis	Metazoa
Danaus_plexippus	Metazoa
Daphnia_magna	Metazoa
Daphnia_pulex	Metazoa
Dendroctonus_ponderosae	Metazoa
Dinothrombium_tinctorium	Metazoa
Drosophila_ananassae	Metazoa
Drosophila_erecta	Metazoa
Drosophila_grimshawi	Metazoa
Drosophila_melanogaster	Metazoa
Drosophila_mojavensis	Metazoa
Drosophila_persimilis	Metazoa
Drosophila_pseudoobscura	Metazoa
Drosophila_sechellia	Metazoa
Drosophila_simulans	Metazoa
Drosophila_virilis	Metazoa
Drosophila_willistoni	Metazoa
Drosophila_yakuba	Metazoa
Folsomia_candida	Metazoa
Heliconius_melpomene	Metazoa
Helobdella_robusta	Metazoa
Hofstenia_miamia	Metazoa
Ixodes_scapularis	Metazoa
Lepeophtheirus_salmonis	Metazoa
Leptotrombidium_deliense	Metazoa
Lingula_anatina	Metazoa
Loa_loa	Metazoa
Lottia_gigantea	Metazoa
Lucilia_cuprina	Metazoa
Mayetiola_destructor	Metazoa
Megaselia_scalaris	Metazoa
Melitaea_cinxia	Metazoa
Mnemiopsis_leidyi	Metazoa
Nasonia_vitripennis	Metazoa
Nematostella_vectensis	Metazoa
Onchocerca_volvulus	Metazoa
Orchesella_cincta	Metazoa
Pediculus_humanus	Metazoa
Pristionchus_pacificus	Metazoa
Rhodnius_prolixus	Metazoa
Sarcoptes_scabiei	Metazoa
Schistosoma_mansoni	Metazoa
Solenopsis_invicta	Metazoa
Stegodyphus_mimosarum	Metazoa
Strigamia_maritima	Metazoa
Strongylocentrotus_purpuratus	Metazoa
Strongyloides_ratti	Metazoa
Teleopsis_dalmanni	Metazoa
Tetranychus_urticae	Metazoa
Thelohanellus_kitauei	Metazoa
Tribolium_castaneum	Metazoa
Trichinella_spiralis	Metazoa
Trichoplax_adhaerens	Metazoa
Zootermopsis_nevadensis	Metazoa
Actinidia_chinensis.Hongyang	Plant
Actinidia_chinensis.Red5	Plant
Aegilops_tauschii	Plant
Amborella_trichopoda	Plant
Ananas_bracteatus.CB5	Plant
Ananas_bracteatus.F153	Plant
Ananas_bracteatus	Plant
Arabidopsis_halleri	Plant
Arabidopsis_lyrata	Plant
Arabidopsis_thaliana	Plant
Asparagus_officinalis	Plant
Beta_vulgaris	Plant
Brachypodium_distachyon	Plant
Brassica_napus	Plant
Brassica_oleracea	Plant
Brassica_rapa	Plant
Cajanus_cajan	Plant
Camelina_sativa	Plant
Castanea_mollissima	Plant
Cerasus_x_yedoensis	Plant
Chlamydomonas_reinhardtii	Plant
Chondrus_crispus	Plant
Citrullus_lanatus.97103	Plant
Citrullus_lanatus.Charleston_Gray	Plant
Corchorus_capsularis	Plant
Cucumis_melo	Plant
Cucumis_sativus.ChineseLong	Plant
Cucumis_sativus.PI183967	Plant
Cucurbita_argyrosperma	Plant
Cucurbita_maxima	Plant
Cucurbita_moschata	Plant
Cucurbita_pepo	Plant
Cyanidioschyzon_merolae	Plant
Daucus_carota	Plant
Dichanthelium_oligosanthes	Plant
Dioscorea_rotundata	Plant
Elaeis_guineensis	Plant
Eucalyptus_grandis	Plant
Eucommia_ulmoides	Plant
Fragaria_iinumae	Plant
Fragaria_nipponica	Plant
Fragaria_nubicola	Plant
Fragaria_orientalis	Plant
Fragaria_vesca	Plant
Fragaria_x_ananassa	Plant
Galdieria_sulphuraria	Plant
Gastrodia_elata	Plant
Glycine_max.Williams_82	Plant
Glycine_max.Zhonghuang_13	Plant
Helianthus_annuus	Plant
Klebsormidium_flaccidum	Plant
Leersia_perrieri	Plant
Lupinus_angustifolius	Plant
Malus_x_domestica.GDDH13	Plant
Malus_x_domestica.HFTH1	Plant
Manihot_esculenta	Plant
Medicago_truncatula	Plant
Musa_acuminata.Banksii	Plant
Musa_acuminata.Calcutta4	Plant
Musa_acuminata.Pahang	Plant
Musa_acuminata.Zebrina	Plant
Musa_balbisiana	Plant
Musa_itinerans	Plant
Musa_schizocarpa	Plant
Nicotiana_attenuata	Plant
Nymphaea_colorata	Plant
Olea_europaea	Plant
Oryza_barthii	Plant
Oryza_brachyantha	Plant
Oryza_glaberrima	Plant
Oryza_glumaepatula	Plant
Oryza_granulata	Plant
Oryza_longistaminata	Plant
Oryza_meridionalis	Plant
Oryza_nivara	Plant
Oryza_punctata	Plant
Oryza_rufipogon	Plant
Oryza_sativa.93-11	Plant
Oryza_sativa.DJ123	Plant
Oryza_sativa.IR64	Plant
Oryza_sativa.IR8	Plant
Oryza_sativa.MH63	Plant
Oryza_sativa.N22	Plant
Oryza_sativa.Nipponbare	Plant
Oryza_sativa.PA64s	Plant
Oryza_sativa.R498	Plant
Oryza_sativa.ZH11	Plant
Oryza_sativa.ZS97	Plant
Ostreococcus_lucimarinus	Plant
Panicum_hallii.FIL2	Plant
Panicum_hallii.HAL2	Plant
Panicum_miliaceum	Plant
Papaver_somniferum	Plant
Petunia_axillaris	Plant
Petunia_inflata	Plant
Phaseolus_vulgaris.BAT93	Plant
Phaseolus_vulgaris.PhaVulg1_0	Plant
Physcomitrella_patens	Plant
Pistacia_vera	Plant
Pisum_sativum	Plant
Populus_alba	Plant
Populus_trichocarpa	Plant
Prunus_avium	Plant
Prunus_domestica	Plant
Prunus_dulcis.Lauranne	Plant
Prunus_dulcis.Texas	Plant
Prunus_persica	Plant
Prunus_yedoensis	Plant
Pyrus_betulifolia	Plant
Pyrus_bretschneideri	Plant
Pyrus_communis	Plant
Raphanus_raphanistrum	Plant
Raphanus_sativus	Plant
Rosa_chinensis	Plant
Rosa_multiflora	Plant
Rubus_occidentalis	Plant
Selaginella_moellendorffii	Plant
Setaria_italica	Plant
Solanum_commersonii	Plant
Solanum_lycopersicum	Plant
Solanum_tuberosum	Plant
Sorghum_bicolor	Plant
Taraxacum_kok-saghyz	Plant
Thellungiella_salsuginea	Plant
Theobroma_cacao	Plant
Theobroma_cacao.Matina1-6	Plant
Trifolium_pratense	Plant
Vernicia_fordii	Plant
Vigna_angularis.Jingnong6	Plant
Vigna_angularis.Vigan1	Plant
Vigna_radiata	Plant
Vitis_vinifera	Plant
Volvox_carteri	Plant
Zea_mays.B73	Plant
Zea_mays.CML247	Plant
Zea_mays.HuangZaoSi	Plant
Zea_mays.Mo17	Plant
Zea_mays.SK	Plant
Zea_mays.W22	Plant
Acanthochromis_polyacanthus	Vertebrate
Ailuropoda_melanoleuca	Vertebrate
Amphilophus_citrinellus	Vertebrate
Amphiprion_ocellaris	Vertebrate
Amphiprion_percula	Vertebrate
Anabas_testudineus	Vertebrate
Anas_platyrhynchos_platyrhynchos	Vertebrate
Anolis_carolinensis	Vertebrate
Anser_brachyrhynchus	Vertebrate
Aotus_nancymaae	Vertebrate
Apteryx_haastii	Vertebrate
Apteryx_owenii	Vertebrate
Apteryx_rowi	Vertebrate
Astatotilapia_calliptera	Vertebrate
Astyanax_mexicanus	Vertebrate
Astyanax_mexicanus_pachon	Vertebrate
Betta_splendens	Vertebrate
Bison_bison_bison	Vertebrate
Bos_indicus_hybrid	Vertebrate
Bos_mutus	Vertebrate
Bos_taurus	Vertebrate
Bos_taurus_hybrid	Vertebrate
Calidris_pugnax	Vertebrate
Calidris_pygmaea	Vertebrate
Callithrix_jacchus	Vertebrate
Callorhinchus_milii	Vertebrate
Canis_familiaris	Vertebrate
Canis_lupus_dingo	Vertebrate
Capra_hircus	Vertebrate
Carlito_syrichta	Vertebrate
Castor_canadensis	Vertebrate
Cavia_aperea	Vertebrate
Cavia_porcellus	Vertebrate
Cebus_capucinus	Vertebrate
Cercocebus_atys	Vertebrate
Chelonoidis_abingdonii	Vertebrate
Chinchilla_lanigera	Vertebrate
Chlorocebus_sabaeus	Vertebrate
Choloepus_hoffmanni	Vertebrate
Chrysemys_picta_bellii	Vertebrate
Ciona_intestinalis	Vertebrate
Ciona_savignyi	Vertebrate
Colobus_angolensis_palliatus	Vertebrate
Cottoperca_gobio	Vertebrate
Coturnix_japonica	Vertebrate
Cricetulus_griseus_chok1gshd	Vertebrate
Cricetulus_griseus_crigri	Vertebrate
Cricetulus_griseus_picr	Vertebrate
Crocodylus_porosus	Vertebrate
Cyanistes_caeruleus	Vertebrate
Cynoglossus_semilaevis	Vertebrate
Cyprinodon_variegatus	Vertebrate
Dasypus_novemcinctus	Vertebrate
Denticeps_clupeoides	Vertebrate
Dipodomys_ordii	Vertebrate
Dromaius_novaehollandiae	Vertebrate
Echinops_telfairi	Vertebrate
Electrophorus_electricus	Vertebrate
Equus_asinus_asinus	Vertebrate
Equus_caballus	Vertebrate
Erinaceus_europaeus	Vertebrate
Erpetoichthys_calabaricus	Vertebrate
Esox_lucius	Vertebrate
Felis_catus	Vertebrate
Ficedula_albicollis	Vertebrate
Fukomys_damarensis	Vertebrate
Fundulus_heteroclitus	Vertebrate
Gadus_morhua	Vertebrate
Gallus_gallus	Vertebrate
Gambusia_affinis	Vertebrate
Gasterosteus_aculeatus	Vertebrate
Gopherus_agassizii	Vertebrate
Gorilla_gorilla	Vertebrate
Gouania_willdenowi	Vertebrate
Haplochromis_burtoni	Vertebrate
Heterocephalus_glaber_female	Vertebrate
Heterocephalus_glaber_male	Vertebrate
Hippocampus_comes	Vertebrate
Homo_sapiens	Vertebrate
Hucho_hucho	Vertebrate
Ictalurus_punctatus	Vertebrate
Ictidomys_tridecemlineatus	Vertebrate
Jaculus_jaculus	Vertebrate
Junco_hyemalis	Vertebrate
Kryptolebias_marmoratus	Vertebrate
Labrus_bergylta	Vertebrate
Larimichthys_crocea	Vertebrate
Lates_calcarifer	Vertebrate
Latimeria_chalumnae	Vertebrate
Lepidothrix_coronata	Vertebrate
Lepisosteus_oculatus	Vertebrate
Lonchura_striata_domestica	Vertebrate
Loxodonta_africana	Vertebrate
Macaca_fascicularis	Vertebrate
Macaca_mulatta	Vertebrate
Macaca_nemestrina	Vertebrate
Manacus_vitellinus	Vertebrate
Mandrillus_leucophaeus	Vertebrate
Marmota_marmota_marmota	Vertebrate
Mastacembelus_armatus	Vertebrate
Maylandia_zebra	Vertebrate
Meleagris_gallopavo	Vertebrate
Melopsittacus_undulatus	Vertebrate
Meriones_unguiculatus	Vertebrate
Mesocricetus_auratus	Vertebrate
Microcebus_murinus	Vertebrate
Microtus_ochrogaster	Vertebrate
Mola_mola	Vertebrate
Monodelphis_domestica	Vertebrate
Monopterus_albus	Vertebrate
Mus_caroli	Vertebrate
Mus_musculus_129s1svimj	Vertebrate
Mus_musculus_aj	Vertebrate
Mus_musculus_akrj	Vertebrate
Mus_musculus_balbcj	Vertebrate
Mus_musculus_c3hhej	Vertebrate
Mus_musculus_c57bl6nj	Vertebrate
Mus_musculus_casteij	Vertebrate
Mus_musculus_cbaj	Vertebrate
Mus_musculus_dba2j	Vertebrate
Mus_musculus_fvbnj	Vertebrate
Mus_musculus_lpj	Vertebrate
Mus_musculus_nodshiltj	Vertebrate
Mus_musculus_nzohlltj	Vertebrate
Mus_musculus_pwkphj	Vertebrate
Mus_musculus_wsbeij	Vertebrate
Mus_pahari	Vertebrate
Mus_spicilegus	Vertebrate
Mus_spretus	Vertebrate
Mustela_putorius_furo	Vertebrate
Myotis_lucifugus	Vertebrate
Nannospalax_galili	Vertebrate
Neolamprologus_brichardi	Vertebrate
Neovison_vison	Vertebrate
Nomascus_leucogenys	Vertebrate
Notamacropus_eugenii	Vertebrate
Notechis_scutatus	Vertebrate
Nothoprocta_perdicaria	Vertebrate
Numida_meleagris	Vertebrate
Ochotona_princeps	Vertebrate
Octodon_degus	Vertebrate
Oreochromis_niloticus	Vertebrate
Ornithorhynchus_anatinus	Vertebrate
Oryctolagus_cuniculus	Vertebrate
Oryzias_latipes	Vertebrate
Oryzias_latipes_hni	Vertebrate
Oryzias_latipes_hsok	Vertebrate
Oryzias_melastigma	Vertebrate
Otolemur_garnettii	Vertebrate
Ovis_aries	Vertebrate
Pan_paniscus	Vertebrate
Pan_troglodytes	Vertebrate
Panthera_pardus	Vertebrate
Panthera_tigris_altaica	Vertebrate
Papio_anubis	Vertebrate
Parambassis_ranga	Vertebrate
Paramormyrops_kingsleyae	Vertebrate
Parus_major	Vertebrate
Pelodiscus_sinensis	Vertebrate
Periophthalmus_magnuspinnatus	Vertebrate
Peromyscus_maniculatus_bairdii	Vertebrate
Petromyzon_marinus	Vertebrate
Phascolarctos_cinereus	Vertebrate
Piliocolobus_tephrosceles	Vertebrate
Poecilia_formosa	Vertebrate
Poecilia_latipinna	Vertebrate
Poecilia_mexicana	Vertebrate
Poecilia_reticulata	Vertebrate
Pogona_vitticeps	Vertebrate
Pongo_abelii	Vertebrate
Procavia_capensis	Vertebrate
Prolemur_simus	Vertebrate
Propithecus_coquereli	Vertebrate
Pteropus_vampyrus	Vertebrate
Pundamilia_nyererei	Vertebrate
Pygocentrus_nattereri	Vertebrate
Rattus_norvegicus	Vertebrate
Rhinopithecus_bieti	Vertebrate
Rhinopithecus_roxellana	Vertebrate
Saimiri_boliviensis_boliviensis	Vertebrate
Salvator_merianae	Vertebrate
Sarcophilus_harrisii	Vertebrate
Scleropages_formosus	Vertebrate
Scophthalmus_maximus	Vertebrate
Serinus_canaria	Vertebrate
Seriola_dumerili	Vertebrate
Seriola_lalandi_dorsalis	Vertebrate
Sorex_araneus	Vertebrate
Spermophilus_dauricus	Vertebrate
Sphenodon_punctatus	Vertebrate
Stegastes_partitus	Vertebrate
Sus_scrofa	Vertebrate
Taeniopygia_guttata	Vertebrate
Takifugu_rubripes	Vertebrate
Tetraodon_nigroviridis	Vertebrate
Theropithecus_gelada	Vertebrate
Tupaia_belangeri	Vertebrate
Tursiops_truncatus	Vertebrate
Urocitellus_parryii	Vertebrate
Ursus_americanus	Vertebrate
Ursus_maritimus	Vertebrate
Vicugna_pacos	Vertebrate
Vombatus_ursinus	Vertebrate
Vulpes_vulpes	Vertebrate
Xenopus_tropicalis	Vertebrate
Xiphophorus_couchianus	Vertebrate
Xiphophorus_maculatus	Vertebrate
Zonotrichia_albicollis	Vertebrate
