Accession	Division
Aedes_aegypti	Metazoa
Anopheles_gambiae	Metazoa
Apis_mellifera	Metazoa
Belgica_antarctica	Metazoa
Bombus_terrestris	Metazoa
Brugia_malayi	Metazoa
Caenorhabditis_brenneri	Metazoa
Caenorhabditis_briggsae	Metazoa
Caenorhabditis_elegans	Metazoa
Culex_quinquefasciatus	Metazoa
Danaus_plexippus	Metazoa
Daphnia_magna	Metazoa
Dendroctonus_ponderosae	Metazoa
Dinothrombium_tinctorium	Metazoa
Drosophila_ananassae	Metazoa
Drosophila_melanogaster	Metazoa
Drosophila_mojavensis	Metazoa
Drosophila_pseudoobscura	Metazoa
Drosophila_sechellia	Metazoa
Drosophila_simulans	Metazoa
Drosophila_willistoni	Metazoa
Drosophila_yakuba	Metazoa
Folsomia_candida	Metazoa
Heliconius_melpomene	Metazoa
Ixodes_scapularis	Metazoa
Lepeophtheirus_salmonis	Metazoa
Lingula_anatina	Metazoa
Loa_loa	Metazoa
Lottia_gigantea	Metazoa
Mayetiola_destructor	Metazoa
Megaselia_scalaris	Metazoa
Nasonia_vitripennis	Metazoa
Nematostella_vectensis	Metazoa
Onchocerca_volvulus	Metazoa
Orchesella_cincta	Metazoa
Pediculus_humanus	Metazoa
Pristionchus_pacificus	Metazoa
Schistosoma_mansoni	Metazoa
Solenopsis_invicta	Metazoa
Stegodyphus_mimosarum	Metazoa
Strigamia_maritima	Metazoa
Strongyloides_ratti	Metazoa
Teleopsis_dalmanni	Metazoa
Tetranychus_urticae	Metazoa
Tribolium_castaneum	Metazoa
Trichinella_spiralis	Metazoa
Trichoplax_adhaerens	Metazoa
Zootermopsis_nevadensis	Metazoa
Actinidia_chinensis.Hongyang	Plant
Aegilops_tauschii	Plant
Amborella_trichopoda	Plant
Ananas_bracteatus	Plant
Arabidopsis_halleri	Plant
Arabidopsis_lyrata	Plant
Arabidopsis_thaliana	Plant
Asparagus_officinalis	Plant
Beta_vulgaris	Plant
Brachypodium_distachyon	Plant
Brassica_napus	Plant
Brassica_oleracea	Plant
Brassica_rapa	Plant
Cajanus_cajan	Plant
Camelina_sativa	Plant
Chlamydomonas_reinhardtii	Plant
Citrullus_lanatus.97103	Plant
Cucumis_melo	Plant
Cucumis_sativus.ChineseLong	Plant
Cucurbita_maxima	Plant
Cucurbita_moschata	Plant
Cucurbita_pepo	Plant
Cyanidioschyzon_merolae	Plant
Daucus_carota	Plant
Dioscorea_rotundata	Plant
Eucalyptus_grandis	Plant
Fragaria_orientalis	Plant
Fragaria_vesca	Plant
Fragaria_x_ananassa	Plant
Glycine_max.Williams_82	Plant
Glycine_max.Zhonghuang_13	Plant
Helianthus_annuus	Plant
Leersia_perrieri	Plant
Lupinus_angustifolius	Plant
Malus_x_domestica.HFTH1	Plant
Manihot_esculenta	Plant
Musa_acuminata.Pahang	Plant
Musa_balbisiana	Plant
Musa_schizocarpa	Plant
Nicotiana_attenuata	Plant
Nymphaea_colorata	Plant
Olea_europaea	Plant
Oryza_barthii	Plant
Oryza_brachyantha	Plant
Oryza_glaberrima	Plant
Oryza_glumaepatula	Plant
Oryza_granulata	Plant
Oryza_longistaminata	Plant
Oryza_meridionalis	Plant
Oryza_nivara	Plant
Oryza_punctata	Plant
Oryza_rufipogon	Plant
Oryza_sativa.93-11	Plant
Oryza_sativa.MH63	Plant
Oryza_sativa.Nipponbare	Plant
Oryza_sativa.PA64s	Plant
Oryza_sativa.R498	Plant
Oryza_sativa.ZH11	Plant
Oryza_sativa.ZS97	Plant
Ostreococcus_lucimarinus	Plant
Panicum_hallii.FIL2	Plant
Papaver_somniferum	Plant
Phaseolus_vulgaris.PhaVulg1_0	Plant
Physcomitrella_patens	Plant
Pisum_sativum	Plant
Populus_trichocarpa	Plant
Prunus_avium	Plant
Prunus_dulcis.Texas	Plant
Prunus_persica	Plant
Pyrus_bretschneideri	Plant
Pyrus_communis	Plant
Rosa_chinensis	Plant
Rubus_occidentalis	Plant
Setaria_italica	Plant
Solanum_lycopersicum	Plant
Solanum_tuberosum	Plant
Sorghum_bicolor	Plant
Thellungiella_salsuginea	Plant
Theobroma_cacao	Plant
Trifolium_pratense	Plant
Vigna_angularis.Vigan1	Plant
Vigna_radiata	Plant
Vitis_vinifera	Plant
Zea_mays.B73	Plant
Zea_mays.HuangZaoSi	Plant
Zea_mays.Mo17	Plant
Zea_mays.SK	Plant
Zea_mays.W22	Plant
Ailuropoda_melanoleuca	Vertebrate
Amphiprion_percula	Vertebrate
Anas_platyrhynchos_platyrhynchos	Vertebrate
Anolis_carolinensis	Vertebrate
Apteryx_haastii	Vertebrate
Astatotilapia_calliptera	Vertebrate
Astyanax_mexicanus	Vertebrate
Betta_splendens	Vertebrate
Bison_bison_bison	Vertebrate
Bos_indicus_hybrid	Vertebrate
Bos_mutus	Vertebrate
Bos_taurus	Vertebrate
Calidris_pugnax	Vertebrate
Callorhinchus_milii	Vertebrate
Canis_familiaris	Vertebrate
Capra_hircus	Vertebrate
Chelonoidis_abingdonii	Vertebrate
Chlorocebus_sabaeus	Vertebrate
Chrysemys_picta_bellii	Vertebrate
Ciona_intestinalis	Vertebrate
Cottoperca_gobio	Vertebrate
Coturnix_japonica	Vertebrate
Cricetulus_griseus_picr	Vertebrate
Cynoglossus_semilaevis	Vertebrate
Denticeps_clupeoides	Vertebrate
Equus_caballus	Vertebrate
Erpetoichthys_calabaricus	Vertebrate
Esox_lucius	Vertebrate
Felis_catus	Vertebrate
Gallus_gallus	Vertebrate
Gasterosteus_aculeatus	Vertebrate
Gorilla_gorilla	Vertebrate
Gouania_willdenowi	Vertebrate
Heterocephalus_glaber_male	Vertebrate
Homo_sapiens	Vertebrate
Ictalurus_punctatus	Vertebrate
Larimichthys_crocea	Vertebrate
Lepisosteus_oculatus	Vertebrate
Macaca_fascicularis	Vertebrate
Macaca_mulatta	Vertebrate
Maylandia_zebra	Vertebrate
Meleagris_gallopavo	Vertebrate
Microcebus_murinus	Vertebrate
Microtus_ochrogaster	Vertebrate
Monodelphis_domestica	Vertebrate
Mus_caroli	Vertebrate
Mus_musculus_129s1svimj	Vertebrate
Mus_musculus_aj	Vertebrate
Mus_musculus_akrj	Vertebrate
Mus_pahari	Vertebrate
Mus_spretus	Vertebrate
Nomascus_leucogenys	Vertebrate
Numida_meleagris	Vertebrate
Oreochromis_niloticus	Vertebrate
Ornithorhynchus_anatinus	Vertebrate
Oryctolagus_cuniculus	Vertebrate
Oryzias_latipes	Vertebrate
Ovis_aries	Vertebrate
Pan_paniscus	Vertebrate
Pan_troglodytes	Vertebrate
Papio_anubis	Vertebrate
Parambassis_ranga	Vertebrate
Parus_major	Vertebrate
Peromyscus_maniculatus_bairdii	Vertebrate
Poecilia_reticulata	Vertebrate
Pongo_abelii	Vertebrate
Rattus_norvegicus	Vertebrate
Scophthalmus_maximus	Vertebrate
Sus_scrofa	Vertebrate
Taeniopygia_guttata	Vertebrate
Takifugu_rubripes	Vertebrate
Tetraodon_nigroviridis	Vertebrate
Theropithecus_gelada	Vertebrate
Xenopus_tropicalis	Vertebrate
Xiphophorus_maculatus	Vertebrate
Zonotrichia_albicollis	Vertebrate
